9
9
----O----
---OOO---
--OOOOO--
-OOOOOOO-
OOOO%OOOO
-OOOOOOO-
--OOOOO--
---OOO---
----O----