9
9
---OOO---
---OOO---
---OOO---
OOOOOOOOO
OOOO#OOOO
OOOOOOOOO
---OOO---
---OOO---
---OOO---