8
--OOO---
--OOO---
--OOO---
OOOOOOOO
OOO%OOOO
OOOOOOOO
--OOO---
--OOO---